.....<....>.....
.v....b<>f....v.
>g....^..^....a<
................
......v...l<....
......p<..^.v..^
^.>i.......>o...
...^...xx.......
.......xx.......
...>c.v........v
v...^>m.d<...v..
.......v^...>n..
.v.....r<.......
.j<.....>e....v.
...h<....^....k<
...^.<.....>....
